----------**--**----------
--**--**--**--**--**--**--
----------**--**----------
--**--**----------**--**--
--**--**----------**--**--
--**--**--**--**--**--**--
--------------------------
--------------------------
--------------------------
--------------------------
__________________________