-----*-*-----
-*-*-*-*-*-*-
-----*-*-----
-*-*-----*-*-
-*-*-*-*-*-*-
-*-*-*-*-*-*-
-------------
-------------
-------------
-------------
_____________