--*-*-*-*-*--
-*-*-*-*-*-*-
--*-*-*-*-*--
-*-*-*-*-*-*-
-------------
-------------
-------------
_____________