-*-*-*-*-*-*-
-*-*-*-*-*-*-
-*-*-*-*-*-*-
-------------
-------------
-------------
_____________