---**--**--**--**--**---
-**--**--**--**--**--**-
---**--**--**--**--**---
-**--**--**--**--**--**-
---**--**--**--**--**---
------------------------
------------------------
------------------------
------------------------
------------------------
------------------------
________________________