--**--------------**--
--**--------------**--
----------------------
----------------------
--**--------------**--
--**--**--**--**--**--
----------------------
----------------------
----------------------
______________________