--**----------**--
--**----------**--
--**----------**--
--**----------**--
--**-**-**-**-**--
------------------
------------------
------------------
------------------
__________________