--**-**-**--
--**-**-**--
--**-**-**--
------------
------------
------------
____________